4 4 4 4 4 4 4 4 4 4 4 4 4 4 4 4 4 4 4 4 4 4 4 4 4 4 4 4 4 4 4 4 4 4 4 4 4 4 4 4 4 4 4 4 4 4 4 4 
4 4 4 4 4 4 4 4 4 4 4 4 4 4 4 4 4 4 4 4 4 4 4 4 4 4 4 4 4 4 4 4 4 4 4 4 4 4 4 4 4 4 4 4 4 4 4 4 
4 4 4 4 4 4 4 4 4 4 4 4 4 4 4 4 4 4 4 4 4 4 4 4 4 4 4 4 4 4 4 4 4 4 4 4 4 4 4 4 4 4 4 4 4 4 4 4 
4 4 4 4 4 4 4 4 4 4 4 4 4 4 4 4 4 4 4 4 4 4 4 4 2 2 2 1 1 1 1 1 1 1 1 1 1 1 1 1 1 1 1 1 1 4 4 4 
4 4 4 4 4 4 4 4 4 4 4 4 4 4 4 4 4 4 4 4 4 4 4 2 2 1 1 7 7 7 7 7 7 7 7 7 7 7 7 7 7 7 7 7 1 4 4 4 
4 4 4 4 4 4 4 4 4 4 4 4 4 4 4 4 4 4 4 4 4 2 2 2 2 1 1 7 3 3 3 3 3 3 3 7 7 3 3 3 3 3 3 7 1 4 4 4 
4 4 4 4 4 4 4 4 4 4 4 4 4 4 4 4 4 4 4 4 2 2 2 2 1 1 1 7 3 7 7 7 7 7 3 7 7 3 4 4 4 4 3 7 1 4 4 4 
4 4 4 4 4 4 4 4 4 4 4 4 4 4 4 4 4 4 4 4 4 2 2 1 1 1 1 7 3 7 7 7 7 7 3 7 7 3 4 4 4 4 3 7 1 4 4 4 
4 4 4 4 4 4 4 4 4 4 4 4 4 4 4 4 4 4 4 2 2 2 2 1 1 1 1 7 3 7 7 7 7 7 3 7 7 3 4 4 4 4 3 7 1 4 4 4 
4 4 4 4 4 4 4 4 4 4 4 4 4 4 4 4 4 4 4 2 1 2 1 1 1 1 1 7 7 7 7 7 7 7 7 7 7 3 7 7 7 7 3 7 1 4 4 4 
4 4 4 1 7 7 7 7 7 7 7 7 7 7 7 7 7 7 7 7 1 1 1 1 1 1 1 7 3 7 3 7 3 7 3 7 7 3 7 4 4 7 3 7 1 4 4 4 
4 4 4 1 1 1 1 1 1 1 1 1 1 1 1 1 1 1 1 1 1 1 1 1 1 1 1 7 7 7 7 0 7 7 7 7 7 3 7 4 4 7 3 7 1 4 4 4 
4 4 4 1 7 7 7 7 7 7 7 7 7 7 1 7 7 7 7 7 7 7 1 1 1 1 1 7 3 7 0 0 0 7 3 7 7 3 7 7 7 7 3 7 1 4 4 4 
4 4 4 1 7 0 0 5 0 0 0 0 0 0 1 0 0 0 0 0 0 7 1 1 1 1 1 7 7 0 0 5 0 0 7 7 7 3 4 4 4 4 3 7 1 4 4 4 
4 4 4 1 7 5 0 0 0 1 1 1 1 1 1 5 0 0 0 0 0 7 1 1 1 1 1 7 3 7 0 0 0 7 3 7 7 3 4 4 4 4 3 7 1 4 4 4 
4 4 4 1 7 5 0 0 5 1 0 0 0 0 1 0 0 5 5 0 0 7 1 1 1 1 1 7 7 7 7 0 7 7 7 7 7 3 4 4 4 4 3 7 1 4 4 4 
4 4 4 1 7 0 0 5 0 1 5 0 4 4 1 1 1 1 0 0 0 7 1 1 1 1 1 7 3 7 3 7 3 7 3 7 7 3 3 3 3 3 3 7 1 4 4 4 
4 4 4 1 7 0 1 1 1 1 0 0 4 4 0 0 0 1 1 1 1 1 1 1 1 1 1 7 7 7 7 7 7 7 7 7 7 7 7 7 7 7 7 7 1 4 4 4 
4 4 4 1 7 0 1 0 0 0 4 4 4 4 4 5 0 1 0 5 0 7 1 1 1 1 1 1 1 1 1 1 1 1 1 1 1 1 1 1 1 1 1 1 1 4 4 4 
4 4 4 1 1 1 1 0 4 4 4 4 4 4 4 4 4 1 5 5 0 7 1 1 1 1 1 7 7 7 7 7 7 7 7 7 7 7 7 7 7 7 7 7 7 4 4 4 
4 4 4 1 7 0 1 5 0 0 4 4 4 4 4 4 4 1 1 5 5 7 1 1 1 1 1 7 4 4 4 4 7 4 4 7 4 4 7 4 4 4 4 4 4 4 4 4 
4 4 4 1 7 0 1 5 0 0 1 4 4 4 4 4 0 0 1 0 0 7 1 1 1 1 1 7 7 7 7 7 7 7 7 7 7 7 7 7 7 7 7 7 7 4 4 4 
4 4 4 1 7 0 1 1 1 1 1 1 4 1 1 1 5 0 1 5 0 7 1 1 1 1 1 1 1 1 1 1 1 1 1 1 1 1 1 1 1 1 1 1 1 4 4 4 
4 4 4 1 7 0 0 0 0 0 1 1 4 4 1 1 1 1 1 0 0 7 1 1 1 1 1 7 7 7 7 7 7 7 7 7 7 7 7 7 7 7 7 7 1 4 4 4 
4 4 4 1 7 0 0 5 5 0 0 1 1 1 1 0 0 0 5 5 0 7 1 1 1 1 1 7 3 3 3 3 3 3 3 3 3 3 3 3 3 3 3 7 1 4 4 4 
4 4 4 1 7 0 0 0 5 0 0 0 1 1 0 0 0 0 0 5 0 7 1 1 1 1 1 7 3 7 7 7 7 7 3 7 7 7 7 7 7 7 3 7 1 4 4 4 
4 4 4 1 1 1 1 1 1 1 1 1 1 1 1 1 1 1 1 1 1 1 1 1 1 1 1 7 3 7 7 7 7 7 3 7 7 7 7 7 7 7 3 7 1 4 4 4 
4 4 4 1 7 7 7 7 7 7 7 7 7 7 7 7 7 7 7 7 7 7 1 7 7 7 7 7 3 7 7 7 7 7 3 7 7 7 3 7 3 3 3 7 1 4 4 4 
4 4 4 1 7 3 3 3 7 3 3 3 7 7 3 3 3 3 3 3 3 7 1 7 3 3 7 3 3 7 7 7 7 7 3 7 7 7 3 7 7 7 3 7 1 4 4 4 
4 4 4 1 7 3 7 7 7 7 7 3 7 7 3 3 3 3 3 3 3 7 1 7 3 7 7 7 7 7 7 7 7 7 3 7 7 7 3 7 7 7 3 7 1 4 4 4 
4 4 4 1 7 3 7 7 7 7 7 3 7 7 3 3 3 3 3 3 3 7 1 7 3 7 7 7 7 7 7 7 7 7 3 7 7 7 3 7 7 7 3 7 1 4 4 4 
4 4 4 1 7 3 7 7 7 7 7 3 7 7 3 3 3 3 3 3 3 7 1 7 3 7 7 7 7 7 7 7 7 7 7 7 7 7 3 7 7 7 3 7 1 4 4 4 
4 4 4 1 7 3 3 3 3 3 3 3 7 7 3 3 3 3 3 3 3 7 1 7 3 3 3 3 3 3 3 3 3 3 3 3 3 3 3 3 3 3 3 7 1 4 4 4 
4 4 4 1 7 7 7 7 7 7 7 7 7 7 7 7 7 7 7 7 7 7 1 7 7 7 7 7 7 7 7 7 7 7 7 7 7 7 7 7 7 7 7 7 1 4 4 4 
4 4 4 1 1 1 1 1 1 1 1 1 1 1 1 1 1 1 1 1 1 1 1 1 1 1 1 1 1 1 1 1 1 1 1 1 1 1 1 1 1 1 1 1 1 4 4 4 
4 4 4 4 4 4 4 4 4 4 4 4 4 4 4 4 4 4 4 4 4 4 4 4 4 4 4 4 4 4 4 4 4 4 4 4 4 4 4 4 4 4 4 4 4 4 4 4 
4 4 4 4 4 4 4 4 4 4 4 4 4 4 4 4 4 4 4 4 4 4 4 4 4 4 4 4 4 4 4 4 4 4 4 4 4 4 4 4 4 4 4 4 4 4 4 4 
4 4 4 4 4 4 4 4 4 4 4 4 4 4 4 4 4 4 4 4 4 4 4 4 4 4 4 4 4 4 4 4 4 4 4 4 4 4 4 4 4 4 4 4 4 4 4 4 
